01234,8x8
00111100
00104111
00133001
11103201
12220111
11130100
00100100
00111100