01234,7x9
111111000
122221111
100311001
103300001
143010001
110011111
011110000