0+234,16x19
000000000000++++000
+++++++0+++++00+++0
+00000+0+00000000+0
+0+++0+0+00++0++0+0
+00000+0++0+00000+0
++0++0+00+0+0+++0+0
0+0+00++++0+0+0+0+0
0+0+0000000+0+++0+0
0+0+0+++000+000+0++
0+0000++0+++0+0000+
0+0+00++34200+0++0+
0+000+++0++00000+0+
0+++++000+00+++000+
00000+0+0+0++000+++
00000+000+0000+++00
00000++++++++++0000