01234,8x8
11111111
10400001
10332001
10020001
10100001
10000001
10000001
11111111