01234,8x8
00000000
00000000
00200000
00334000
00000000
00000000
00000000
00000000